BBBBBBBBBBBBBBBBBBBBBBBBBBBBBBB
B1XXXXXXXXXXHHHXXXXXXHXXXXXXXXB
BXBHBXBHBXBXBXBXBXBHBXBXBXBXBXB
BXXXXXXXXXXXXXXXXXXXXXXXXXHXXXB
BXBXBXBHBXBXBXBXBXBXBXBXBXBXBXB
BXXXXXXHXXXXXXXXXHXXXXXHXXXHXXB
BXBXBXBHBHBXBXBXBXBXBXBXBXBXBHB
BXXXXXXXXHXXXXXXXXXXXXXXXXHXXXB
BXBXBXBXBXBHBXBXBXBXBXBXBHBHBXB
BXHXXXXXXXXXHHXXXXXXXXXXHXXXXXB
BXBHBXBXBXBXBXBHBXBXBXBXBXBXBXB
BXHXXXXXXXXXXXXXXXXXXXXXHXXXX2B
BBBBBBBBBBBBBBBBBBBBBBBBBBBBBBB
